35 20
###################################
#........##..##.....##..##........#
#.......##.......+.......##.......#
#......##........=........##......#
#.....##...................##.....#
#....##.....................##....#
#...##.......................##...#
#..##.........................##..#
#.##...........................##.#
#.................................#
#.##...........................##.#
#..##.........................##..#
#...##.......................##...#
#..........##...........##........#
#...........##.........##.........#
#............##.......##..........#
#.............##.....##...........#
#..............##...##............#
#...............#####.............#
###################################

